2 15 30
##############################
#p          *     1          #
# # # # # # # # # # # # # #  #
#       f*    1     #        #
# # # # # #*# # #*#*# # # # ##
#     3     ** b*   *   1    #
# # # # # # # # # #*# #*# # ##
#      1              1      #
# # # # #*# # # #*#*# # # # ##
#*    *  *       *    2      #
# #*# # # # # # #*# # # # # ##
#    3       *   *     x*    #
# # # #*# # # # #*#*# # # # ##
#      *   s*  *   2  *      #
##############################
